1111111111111
10010000000C1
1000011111001
1000110EC0P01
1111110111111
10001100C0001
1111111111111
