111111111
11111EPC1
111111111
